10.ox
..o.......
..oo...oo.
..........
....oo...o
o...o..o..
.oo..o...o
...o.o....
o...o.....
o..o..o...
.o..o...o.
